date,description,amount,currency,balance
2025-05-31,Opening Balance,0,USD,15000.00
2025-06-02,SaaS Pro Monthly,-199.00,USD,14801.00
2025-06-10,Client Payment INV-203,+5400.00,USD,20201.00
2025-06-11,SaaS Ultra Monthly,-199.00,USD,20002.00
2025-06-15,Vendor X Payment INV-1043,-1250.00,USD,18752.00
2025-06-20,FX Fee (EUR wire),-18.50,USD,18733.50
2025-06-20,Client Payment EU-818,+4300.00,EUR,??
