date,description,amount,balance
2025-06-01,Opening Balance,0,15000.00
2025-06-02,SaaS Pro Monthly,-199.00,14801.00
2025-06-10,Client Payment INV-203,+5400.00,20201.00
2025-06-15,Vendor X Payment INV-1043,-1250.00,18951.00
2025-06-22,Cloud Compute,-820.00,18131.00
2025-06-30,Office Rent,-3800.00,14331.00
